Input	KEYWORD1
Output	KEYWORD1
PLCtimer	KEYWORD1
Counter	KEYWORD1
PLC	KEYWORD1
getState	KEYWORD2
setState	KEYWORD2
update	KEYWORD2
increment	KEYWORD2
decrement	KEYWORD2
reset	KEYWORD2
setPreset	KEYWORD2
isPresetReached	KEYWORD2
addInput	KEYWORD2
addOutput	KEYWORD2
addTimer	KEYWORD2
addCounter	KEYWORD2
getAverageExecutionTime	KEYWORD2
getWorstCaseExecutionTime	KEYWORD2
resetWorstCaseExecutionTime	KEYWORD2
isHealthy	KEYWORD2